1 0 0 0 0 0 0 0 0 0 0 0 0 0 0 0
1 0 0 0 0 0 0 0 0 0 3 1 1 2 0 0
1 0 0 0 0 0 0 0 0 0 3 2 5 2 0 0
1 0 0 0 0 0 0 0 0 0 3 4 4 0 0 0
1 1 4 0 0 0 0 0 0 0 3 4 0 0 0 0
0 1 4 4 0 0 0 9 0 0 3 4 0 0 0 0 
0 0 0 4 4 4 4 4 4 4 4 4 0 1 1 0
0 0 0 0 0 4 4 4 1 1 0 0 0 1 1 0
0 0 0 0 0 4 4 4 1 1 0 3 3 3 3 3
0 0 0 0 0 4 4 4 1 2 0 3 3 3 3 3
0 0 0 0 0 4 4 4 1 2 0 3 3 3 3 3
0 0 0 0 0 4 4 4 1 1 0 3 3 3 3 3

